#################
#6   !       #$ #
#           %#  #
########### ### #
#          *    #
#     *         #
#          *    #
#     *         #
####### 0 #######
#          *    #
#     *         #
#          *    #
#     *         #
# ### ###########
#  #%           #
# $#       !   8#
#################